1111111111111111111
10000011111C1111111
100C0010000000000C1
1E000C0000101111111
1101001000100C00001
11P1001111111111111
1111111111111111111